1,7,2,1,3,9,2,3,1,1
2,1,2,2,3,8,1,2,1,1
9,2,3,1,3,1,2,1,2,2
3,3,1,1,3,9,3,2,3,1
2,1,1,2,7,1,1,2,2,3
3,2,5,3,3,1,3,2,3,3
3,2,1,3,3,2,3,2,2,1
2,3,3,2,3,3,2,3,2,3
2,2,2,2,2,2,3,3,1,2
1,3,2,1,1,1,3,1,2,2